1111111111111111111111111
1E00000000000V0C0000H00E1
1010V10100100H00100010101
1010010010101010000010101
1000000000000000000000001
1P00000V0C00CE000V00000C1
1111111111111111111111111